NO ./textures/north.xpm
SO ./textures/south.xpm
WE ./textures/west.xpm
EA ./textures/east.xpm

F 0,100,50
C 50,100,200

11111111111111111111111111111
10000000000000000000000000001
10111111111000111111111000001
10100000001000100000001000001
10101111101000101111101000001
10101000001000100000101000001
10101011111000111110101000001
10100000000000000000101000001
10111111111111111111101000001
10000000000N00000000001000001
10111111111111111111111000001
10000000000000000000000000001
11111111111111111111111111111
