NO ./sprites/matrix.xpm
SO ./sprites/matrix.xpm
WE ./sprites/matrix.xpm
EA ./sprites/matrix.xpm


F 100,50,25
C 100,150,250

1111111
1000001
1000W01
1000001
1111111
