NO ./sprites/matrix.xpm
SO ./sprites/matrix.xpm
WE ./sprites/matrix.xpm
EA ./sprites/matrix.xpm

F 50,150,200
C 200,200,200

1111111
1000001
10E0001
1000001
1111111
