NO ./sprites/matrix_01.xpm
SO ./sprites/matrix_01.xpm
WE ./sprites/matrix_01.xpm
EA ./sprites/matrix_01.xpm

F 30,30,30
C 0,0,0

11111111111111111111111111111111111111111111
10000000000000000000000000000000000000000001
10101010101010101N10101010101010101010101011
10101010101010101010101010101010101010101011
10101010101010101010101010101010101010101011
10101010101010101010101010101010101010101011
10101010101010101010101010101010101010101011
10101010101010101010101010101010101010101011
10101010101010101010101010101010101010101011
10101010101010101010101010101010101010101011
10101010101010101010101010101010101010101011
10101010101010101010101010101010101010101011
10101010101010101010101010101010101010101011
10101010101010101010101010101010101010101011
10101010101010101010101010101010101010101011
10101010101010101010101010101010101010101011
10101010101010101010101010101010101010101011
10101010101010101010101010101010101010101011
10101010101010101010101010101010101010101011
10101010101010101010101010101010101010101011
10101010101010101010101010101010101010101011
10101010101010101010101010101010101010101011
10101010101010101010101010101010101010101011
10101010101010101010101010101010101010101011
10101010101010101010101010101010101010101011
10101010101010101010101010101010101010101011
11111111111111111111111111111111111111111111