NO ./sprites/kuzey.xpm
SO ./sprites/guney.xpm
WE ./sprites/bati.xpm
EA ./sprites/dogu.xpm
F 220,100,0
C 225,30,0
111111111111111111111
11N111111111111111111
1111111110 1111111111
111111111111111111111
111111111111111111111