NO ./sprites/kuzey.xpm
SO ./sprites/guney.xpm
WE ./sprites/bati.xpm
EA ./sprites/dogu.xpm
F 220,100,0
C 225,30,0
11111111111111111111
1N001000000000000
11111111111111111111